FE8 - Mountainous - 6c006d6e
15 17
98 112 82 82 79 135 78 98 98 98 98 443 806 33 939 848 939
98 168 111 6 6 38 6 135 98 66 443 1006 806 1006 971 880 971
98 98 98 112 111 111 38 6 135 443 1006 1006 806 507 506 1006 1006
79 79 79 80 98 98 112 443 1006 1006 1006 1007 904 1006 507 1006 1006
111 111 111 111 79 79 38 1006 1006 1006 1006 1006 806 1006 1006 1006 1006
840 808 808 907 142 38 6 443 907 840 808 808 907 939 1007 1006 939
374 871 871 970 166 6 443 1007 970 374 871 871 970 971 507 506 971
1006 1006 1006 507 98 166 443 1007 806 974 911 911 1006 1006 1006 507 1007
1006 1006 1006 98 98 98 1007 1007 806 942 1007 1007 1007 1006 1006 1006 1006
1006 945 1006 475 98 443 1006 1007 806 942 506 842 774 878 879 774 841
1006 1007 774 774 774 774 1006 1006 806 942 507 806 942 1007 1007 1007 807
1006 1006 871 871 871 871 1006 1006 907 942 1006 904 942 1007 1007 1006 807
1006 1006 911 911 911 911 1006 1006 911 1006 1006 806 942 939 939 1007 807
1006 1006 1006 1006 1006 1006 1007 1006 1006 1006 1006 905 943 971 971 1007 905
906 1006 808 808 808 808 808 808 808 808 808 937 765 878 879 765 937
