newcastle4
27 19
525 460 460 460 460 918 918 918 797 798 799 918 918 918 460 460 460 460 493
491 419 849 849 849 950 950 950 829 830 831 950 950 950 849 849 849 487 458
491 849 849 849 849 849 1014 982 912 913 914 982 1014 849 849 849 849 849 458
449 849 619 621 620 849 583 1014 942 624 942 1014 583 849 619 621 620 849 450
481 849 527 530 528 849 966 596 530 625 530 628 966 849 527 530 528 849 482
491 849 651 653 652 849 849 688 627 627 627 689 849 849 651 653 652 849 458
491 849 849 849 849 849 849 849 849 849 849 849 849 849 849 849 849 849 458
552 746 746 746 746 493 452 454 454 454 454 454 453 525 746 746 746 746 553
419 786 786 786 786 459 452 454 454 454 454 454 453 459 787 786 786 786 487
784 656 595 657 785 459 784 719 785 785 785 719 785 459 784 656 595 657 785
784 596 33 628 785 459 784 783 785 785 785 783 785 459 784 596 33 628 785
784 688 627 689 785 459 452 454 454 454 454 454 453 459 784 688 627 689 785
784 719 785 719 785 459 821 719 821 821 821 719 821 459 784 719 785 719 785
784 783 785 783 785 459 821 815 821 821 821 815 821 459 784 783 785 783 785
784 785 785 785 785 459 452 454 454 454 454 454 453 459 784 785 785 785 785
746 746 746 746 746 553 452 454 454 454 454 454 453 552 746 746 746 746 746
778 778 417 418 778 781 719 821 821 821 821 821 719 780 778 417 418 778 778
821 821 619 620 821 821 815 619 595 621 595 620 815 821 821 619 620 821 821
821 821 651 652 821 821 821 596 619 621 620 628 821 821 821 651 652 821 821
821 719 821 821 719 821 821 527 527 530 528 528 821 821 719 821 821 719 821
821 815 619 620 815 821 821 596 651 653 652 628 821 821 815 619 620 815 821
821 821 651 652 821 821 821 651 627 653 627 652 821 821 821 651 652 821 821
419 821 821 821 821 821 719 821 821 821 821 821 719 821 821 821 821 821 487
603 604 605 606 607 821 815 821 656 595 657 821 815 821 603 604 605 606 607
635 636 637 638 639 821 821 821 596 530 628 821 821 821 635 636 637 638 639
667 668 669 670 671 821 821 821 688 627 689 821 821 821 667 668 669 670 671
699 700 701 702 703 821 821 821 821 821 821 821 821 821 699 700 701 702 703
