Village v2 - Night Tileset
18 13
454 454 454 454 458 225 419 419 456 454 454 454 454
486 486 486 486 458 419 225 225 456 454 489 489 489
90 91 92 93 453 425 425 425 454 458 273 90 91
122 123 124 125 453 454 454 454 454 458 305 122 123
422 454 454 422 454 454 454 454 454 454 425 425 425
454 454 454 454 454 486 486 486 454 454 489 489 489
79 80 81 454 455 148 94 95 453 458 142 16 143
111 112 113 454 455 89 126 127 453 458 174 48 175
454 454 454 454 454 422 454 422 454 458 419 225 225
454 454 486 486 486 454 454 489 489 490 225 225 419
454 455 28 29 30 453 458 144 19 145 225 419 225
454 455 60 61 62 454 458 176 51 177 225 225 225
454 454 422 422 422 454 458 225 225 225 419 225 419
454 454 489 489 489 489 490 225 225 225 419 419 225
454 458 225 225 225 225 225 225 576 577 225 419 225
454 458 576 577 225 225 225 225 608 609 225 225 225
454 458 608 609 225 419 448 225 225 225 225 225 419
454 458 225 225 352 353 480 480 419 225 225 419 352
