Village v2 - Night Tileset
25 15
224 419 419 224 224 456 454 454 454 458 224 60 61 62 419
419 82 83 84 419 456 454 454 454 458 224 224 419 419 224
224 114 115 116 419 456 454 454 454 454 425 425 425 425 425
419 273 224 419 224 456 454 454 454 454 489 489 489 489 489
419 305 224 419 224 456 454 454 454 458 224 419 419 224 224
224 224 224 224 224 456 90 91 95 458 224 148 94 95 224
224 419 224 419 224 456 122 123 127 458 224 120 126 127 224
419 224 224 419 224 456 454 454 454 458 224 224 224 419 224
224 224 224 224 224 456 454 454 454 458 224 419 224 224 419
425 425 425 425 425 454 454 454 454 454 425 425 425 425 425
489 489 489 489 489 454 454 454 454 454 489 489 489 489 489
224 224 224 419 224 456 454 454 454 458 419 224 224 224 224
419 224 224 224 224 456 454 454 454 458 224 224 419 419 224
18 19 20 419 224 456 79 80 81 458 224 419 15 16 17
50 51 52 419 224 456 111 112 113 458 224 224 47 48 49
224 224 419 224 224 456 454 454 454 458 224 224 419 224 419
419 224 224 224 224 456 454 454 454 458 224 419 224 224 224
425 425 425 425 425 454 454 454 454 454 425 425 425 425 425
486 486 486 486 486 454 454 454 454 454 454 454 454 454 454
93 148 94 92 93 276 277 277 277 278 591 591 591 819 591
125 89 126 63 125 276 277 277 277 278 623 624 623 851 623
786 784 845 845 845 845 845 845 845 845 845 845 785 845 817
818 816 877 877 877 877 784 784 782 877 877 877 877 877 877
877 877 877 786 785 877 816 816 846 785 877 877 784 847 848
877 877 877 818 877 877 877 877 877 877 877 877 816 879 880
