Village v2 - Night Tileset
24 21
419 419 225 456 458 225 225 419 225 456 454 458 225 419 419 225 456 458 225 419 225
419 225 225 456 458 225 419 225 225 456 454 458 225 225 419 225 456 458 419 225 225
425 425 425 454 454 425 425 425 425 454 454 454 425 425 425 425 454 454 425 425 425
454 454 454 454 454 454 454 454 454 454 454 454 454 454 454 454 454 454 454 454 454
489 489 489 454 454 489 489 489 454 489 489 489 454 454 454 454 454 454 489 489 489
225 225 225 456 458 225 225 225 359 225 416 225 456 454 454 454 454 458 417 418 225
148 94 95 456 458 148 94 95 359 224 417 418 456 79 80 81 454 458 225 90 91
89 126 127 456 458 89 126 127 359 419 817 224 456 111 112 113 454 458 419 122 123
225 359 225 456 458 225 359 225 359 224 224 419 456 454 454 454 454 458 225 416 456
425 454 425 454 454 425 454 425 454 425 425 425 454 454 454 454 454 454 425 425 454
454 454 454 454 454 454 454 454 454 454 454 454 454 454 454 454 454 454 454 454 454
489 489 489 489 489 454 454 454 489 489 489 489 489 454 454 454 489 489 489 489 489
225 225 225 225 225 456 454 458 225 225 225 225 225 456 454 458 225 225 225 225 225
94 92 93 273 225 456 454 458 225 148 94 95 225 456 454 458 225 90 91 92 93
126 124 125 305 225 456 454 458 225 89 126 127 225 456 454 458 225 122 123 124 125
454 458 225 225 225 456 454 458 225 225 359 225 225 456 454 458 225 225 456 458 225
454 454 425 425 425 454 454 454 425 425 454 425 425 454 454 454 425 425 454 454 425
454 454 454 454 454 454 454 454 454 454 454 454 454 454 454 454 454 454 454 454 454
454 454 454 489 489 489 489 489 489 454 454 454 489 489 489 489 489 489 454 454 454
454 454 458 419 225 15 16 17 225 456 454 458 419 18 19 20 225 419 456 454 454
454 454 458 225 419 47 48 49 419 456 454 458 225 50 51 52 419 419 456 454 454
454 454 454 425 425 425 454 425 425 454 454 454 425 425 454 425 425 425 454 454 454
454 454 454 454 454 454 454 454 454 454 454 454 454 454 454 454 454 454 454 454 454
454 454 454 454 454 454 454 454 454 454 454 454 454 454 454 454 454 454 454 454 454
