newcastle4
43 30
785 785 785 785 785 785 459 784 785 785 785 785 785 785 785 785 785 785 458 784 785 785 785 785 785 785 785 785 785 459
785 785 785 785 785 785 496 784 785 785 785 785 785 785 785 785 785 785 458 784 785 785 785 785 785 785 785 785 785 459
785 785 785 785 785 785 459 784 785 719 785 785 785 785 785 719 785 785 458 784 785 719 785 785 785 785 785 719 785 459
427 427 427 427 427 427 553 784 785 783 785 785 491 784 785 783 785 785 490 784 785 783 785 785 491 784 785 783 785 459
785 785 785 785 785 785 785 785 785 785 785 785 491 784 785 785 785 785 785 785 785 785 785 785 491 784 785 785 785 459
785 785 785 785 785 785 785 785 785 785 785 785 491 784 785 785 785 785 785 785 785 785 785 785 491 784 785 785 785 459
427 427 493 452 454 453 525 93 30 30 30 30 30 30 30 30 30 30 30 30 30 30 30 30 493 784 785 785 785 459
785 785 459 452 454 453 459 121 58 58 58 58 58 58 58 58 58 58 58 58 58 58 58 59 459 784 785 785 785 459
785 785 459 820 821 821 459 821 821 821 821 821 821 459 820 821 821 821 821 821 821 821 821 821 459 784 785 785 785 459
33 785 459 820 821 821 449 821 33 821 33 821 821 459 820 821 525 427 427 521 820 821 821 821 459 784 785 785 785 459
785 33 459 820 821 821 481 821 821 33 821 33 821 449 820 821 459 785 785 459 820 821 821 821 459 784 785 719 785 459
33 785 459 820 821 821 459 821 821 821 821 821 821 481 820 821 459 785 785 496 820 821 821 821 459 784 785 783 785 459
785 33 459 820 821 821 93 30 30 30 30 30 30 95 820 821 552 426 426 553 820 821 821 821 459 784 785 785 785 459
785 785 459 820 821 821 121 58 58 58 58 58 58 123 820 821 821 821 821 821 821 821 821 821 459 784 785 785 785 459
785 785 459 820 821 821 821 821 821 821 821 821 821 821 821 821 821 821 821 821 821 821 821 525 553 784 785 785 785 459
426 426 426 427 427 883 883 885 427 426 427 426 427 521 820 821 822 821 822 821 822 821 525 484 784 785 785 785 785 484
722 722 722 722 722 915 916 915 723 722 722 722 722 459 431 902 521 820 822 525 902 521 459 679 452 454 454 454 453 679
721 721 721 656 595 596 624 949 595 657 721 721 721 459 463 419 459 820 822 459 419 459 459 743 452 454 454 454 453 743
721 719 720 688 627 688 660 689 627 689 721 719 720 491 430 787 553 820 821 552 787 553 459 820 821 821 821 821 821 821
721 751 721 721 721 688 687 689 721 721 721 751 721 458 773 483 773 820 822 773 483 773 459 820 821 821 821 821 821 821
484 720 721 484 427 427 426 427 426 484 720 721 721 484 806 451 805 820 821 805 451 805 459 820 821 821 821 821 821 821
679 452 453 679 89 27 805 89 27 679 452 454 453 679 823 825 824 821 822 825 824 822 459 820 821 821 821 821 821 821
743 452 453 743 823 824 825 824 825 743 452 454 453 743 820 822 821 822 821 822 821 822 459 820 821 821 821 821 821 821
824 825 824 825 822 821 822 821 822 825 824 825 824 825 822 821 822 821 822 821 822 822 459 820 821 821 821 821 821 821
821 822 821 822 821 822 821 822 821 822 821 822 821 821 821 822 821 822 821 822 821 822 93 30 30 30 30 30 30 30
822 525 426 426 426 426 521 820 822 821 822 821 525 426 426 426 426 426 426 521 820 821 121 58 58 58 58 58 58 58
821 459 723 786 786 722 459 820 821 719 719 820 459 723 722 722 722 722 722 459 820 822 821 821 821 821 821 821 821 821
822 496 784 33 33 784 459 820 822 815 815 858 459 720 721 721 721 721 721 459 820 821 821 821 821 821 821 821 821 821
821 459 720 786 786 721 459 820 821 822 821 822 459 720 721 721 721 721 721 459 820 822 821 821 821 821 821 821 821 821
822 552 426 426 416 426 553 820 822 719 719 820 552 484 720 484 521 720 721 459 820 821 821 821 821 821 821 821 821 821
821 824 825 824 825 824 825 822 821 815 815 858 88 742 483 742 459 720 721 459 820 822 821 821 821 821 821 821 821 821
822 821 822 821 822 821 822 821 822 821 822 821 824 826 824 826 459 720 721 459 820 821 821 821 821 821 821 821 821 821
426 426 426 426 426 426 426 426 521 820 821 822 821 822 821 822 459 720 721 552 426 426 426 426 426 427 821 821 821 821
897 897 897 897 897 897 897 898 459 820 822 719 820 719 820 821 459 720 721 722 722 722 721 721 721 423 821 821 821 821
929 929 929 929 929 929 929 930 459 820 821 815 822 815 858 822 459 720 721 721 721 721 721 721 721 519 821 821 821 821
3 36 35 8 3 4 3 3 554 820 822 821 822 821 822 821 459 720 721 721 721 721 721 721 721 519 821 821 821 821
162 583 433 426 426 426 426 426 553 820 821 719 820 719 820 822 93 31 484 417 418 484 93 30 30 31 821 821 821 821
41 554 723 786 722 825 824 825 824 821 822 815 858 815 858 821 121 59 742 452 453 742 121 58 58 59 821 821 821 821
43 554 784 33 784 525 426 426 521 820 821 822 821 822 821 822 825 824 826 824 825 826 821 821 821 821 821 821 821 821
162 554 720 786 721 459 899 900 459 820 822 821 822 821 822 821 822 821 822 821 822 821 821 821 821 821 821 821 821 821
99 583 433 426 426 583 931 930 583 433 426 426 583 820 821 822 821 822 583 430 426 426 426 426 426 426 426 426 426 426
100 615 896 897 898 615 2 3 615 896 897 898 615 452 454 454 454 453 615 896 897 898 897 898 897 898 897 898 897 898
41 711 928 929 930 711 34 72 713 928 929 930 743 452 454 454 454 453 743 928 929 930 929 930 929 930 929 930 929 930
