newcastle4
21 23
131 194 131 131 131 729 724 790 12 13 14 131 194 131 131 131 194 131 131 131 194 131 131
131 131 131 131 131 729 724 790 44 45 46 131 194 194 131 131 131 131 131 194 131 131 194
131 131 194 194 131 729 724 724 756 724 756 665 665 665 665 665 665 665 665 665 665 665 665
131 131 131 194 131 729 724 724 724 697 697 788 788 788 788 788 788 788 788 788 697 697 697
194 131 131 131 131 729 724 724 794 131 131 520 484 746 746 746 746 746 484 521 131 131 131
131 194 131 131 458 452 454 453 746 746 746 493 516 912 797 1015 799 912 516 458 194 131 131
131 131 131 131 458 720 721 721 721 721 721 458 548 915 829 624 831 915 548 458 131 194 131
131 131 131 525 553 720 721 721 721 721 721 458 436 436 619 621 620 436 436 458 131 131 131
131 194 131 458 720 721 910 721 910 721 721 458 436 436 651 653 652 436 436 496 131 131 194
762 131 131 458 720 721 751 721 751 721 721 458 436 436 436 436 436 436 436 458 131 131 131
730 131 194 458 720 721 721 721 721 721 721 525 746 452 454 454 454 453 746 493 194 131 194
724 762 131 748 746 746 656 595 657 746 746 749 787 785 785 785 785 785 785 458 131 131 194
724 730 131 778 778 778 688 627 689 778 778 787 785 785 656 595 657 785 785 458 131 131 131
724 724 665 421 849 849 849 849 849 849 421 785 910 785 596 530 628 785 785 458 131 131 131
724 724 724 422 849 849 849 849 849 849 422 785 783 785 688 627 689 785 785 458 131 194 131
724 697 697 422 849 849 849 849 849 849 422 785 785 785 785 785 785 785 785 458 131 194 131
794 131 131 746 746 746 746 746 746 746 746 746 746 746 452 454 453 746 746 746 194 131 131
131 194 131 778 778 778 778 778 778 778 778 778 778 778 452 454 453 778 778 778 131 131 194
194 131 131 194 131 131 131 131 131 131 131 194 131 131 729 724 730 131 131 194 131 131 131
131 131 194 131 131 131 131 194 194 131 131 131 131 131 729 724 724 665 665 665 665 665 665
131 131 131 131 131 131 131 131 131 131 131 131 131 131 729 724 724 724 724 724 724 724 724
