FE8 - Fields - 01000203
25 20
720 70 103 810 811 812 782 102 103 66 720 67 621 529 774 67 396 66 166 167
44 103 720 842 843 844 66 720 66 66 66 591 459 429 718 782 396 130 130 785
98 98 98 98 164 98 782 98 98 98 782 559 459 429 560 130 328 267 130 66
817 74 75 720 66 782 849 98 932 165 782 778 456 492 561 782 236 265 196 66
849 142 137 162 98 98 782 98 99 162 652 783 689 545 496 130 146 176 228 800
67 102 167 817 130 130 130 99 99 98 98 66 66 559 780 204 402 295 98 498
720 67 720 932 98 807 808 809 720 720 98 98 98 679 720 264 271 782 162 131
743 99 99 130 130 839 840 841 720 66 782 98 720 782 782 230 231 99 783 774
459 497 782 130 783 871 875 873 199 720 99 98 130 932 162 162 98 742 591 651
747 592 67 67 836 164 782 99 230 209 99 14 98 98 720 817 493 456 614 424
98 720 782 67 67 165 782 131 131 99 130 166 79 135 720 98 463 523 562 618
164 98 98 782 99 783 99 720 99 99 98 98 172 110 743 679 559 513 618 492
882 98 807 808 809 66 99 720 99 164 783 130 130 384 515 418 581 619 545 551
914 782 839 840 841 165 131 130 130 850 130 99 679 559 587 422 553 417 618 582
946 815 871 875 873 782 720 98 98 98 99 99 98 778 160 747 585 424 492 432
946 163 132 98 98 98 98 98 98 932 66 782 98 782 162 711 594 747 432 687
783 901 132 132 98 130 785 98 98 78 134 43 45 99 720 98 98 782 132 720
99 165 132 132 98 98 98 98 44 6 169 98 782 98 720 782 162 782 98 631
720 783 941 942 943 848 98 98 70 6 137 99 162 98 98 815 67 99 99 604
98 99 973 974 975 98 66 44 6 38 38 137 70 79 135 75 782 164 98 600
98 932 1005 1006 1007 932 66 66 102 6 38 6 167 142 6 109 132 132 44 2
720 198 273 435 199 66 66 782 164 113 6 103 99 102 103 162 67 132 98 600
67 230 305 307 294 273 199 98 782 102 103 162 98 99 782 782 98 98 596 635
720 162 783 131 782 230 401 337 209 67 631 597 98 631 570 570 570 630 600 98
275 203 132 163 162 198 433 199 98 631 598 628 597 601 720 720 98 599 605 98
