8e00c990
30 23
19 19 19 19 90 175 45 174 84 135 98 99 100 138 90 175 45 174 84 19 19 19 19
19 19 19 19 122 175 45 174 116 167 130 35 132 170 122 175 45 174 116 19 19 19 19
19 19 19 139 69 207 45 206 172 160 7 67 7 166 171 207 45 206 69 140 19 19 19
19 19 19 264 333 236 45 238 101 330 7 6 107 330 333 236 45 238 101 265 19 19 19
19 25 26 232 8 268 269 270 6 362 74 75 76 362 8 268 269 270 6 233 20 19 19
98 99 100 264 7 107 107 107 107 394 6 6 6 394 107 107 107 107 107 265 98 99 100
130 35 132 232 7 107 107 107 107 107 107 107 107 107 107 107 107 107 107 233 130 35 132
162 67 164 264 7 107 107 107 171 161 161 161 161 161 172 7 107 107 107 265 162 67 164
194 195 196 232 7 107 107 107 139 161 161 161 161 161 140 7 107 107 107 233 194 195 196
226 227 228 264 74 75 75 76 264 333 101 101 101 101 265 74 75 75 76 265 226 227 228
258 259 260 232 74 75 75 76 264 8 6 6 6 6 265 74 75 75 76 233 258 259 260
258 259 260 264 74 75 75 76 232 7 109 107 109 107 233 74 75 75 76 265 258 259 260
258 259 260 232 7 107 107 107 160 161 161 161 161 161 166 7 107 107 107 233 258 259 260
258 259 260 264 7 107 107 107 331 332 333 101 101 331 332 7 107 107 107 265 258 259 260
258 259 260 232 7 107 107 107 363 364 333 101 101 363 364 7 107 107 107 233 258 259 260
258 259 260 264 7 107 107 107 6 6 6 6 6 6 6 107 107 107 107 265 258 259 260
258 259 260 160 172 7 107 107 107 107 107 107 107 107 107 107 107 107 171 166 258 259 260
258 259 260 193 330 74 75 75 76 139 161 161 161 140 74 75 75 76 330 193 258 259 260
258 259 260 193 330 74 75 75 76 264 333 101 101 265 74 75 75 76 330 193 258 259 260
258 259 260 193 330 7 107 107 107 232 8 109 6 233 7 107 107 107 330 193 258 259 260
258 259 260 203 330 7 107 107 107 160 161 161 161 166 7 107 107 107 330 203 258 259 260
161 161 161 299 362 161 140 7 107 192 101 101 101 198 7 107 139 161 362 299 69 69 69
6 6 6 300 6 6 265 7 107 6 6 6 6 6 107 107 264 8 6 300 394 6 6
107 107 107 107 107 5 233 7 107 107 107 107 107 107 107 107 232 7 107 107 107 107 107
161 161 161 161 161 161 166 7 107 107 107 107 107 107 107 107 160 161 161 161 161 161 161
193 193 193 193 193 193 193 74 75 75 75 75 75 75 75 76 193 193 193 193 193 193 193
193 193 193 193 193 193 193 74 75 75 75 75 75 75 75 76 193 193 193 193 193 193 193
203 203 203 203 203 203 203 74 75 75 75 75 75 75 75 76 334 203 203 203 203 203 203
299 299 299 299 299 299 299 41 75 75 75 75 75 75 75 76 366 299 299 299 299 299 299
300 300 300 300 300 300 300 300 300 300 300 300 300 300 300 300 300 300 300 300 300 300 300
