FE8 - Village - 0e000f10
25 20
800 801 804 864 746 745 746 747 516 937 938 939 518 808 929 810 932 745 934 935
832 833 836 896 778 777 778 779 518 969 970 971 516 840 838 842 997 777 966 967
516 518 516 587 587 587 516 516 518 516 518 516 587 520 587 555 518 555 484 457
516 518 586 419 256 256 585 516 516 516 518 522 256 419 256 585 516 518 516 518
518 522 256 256 419 419 256 521 518 516 516 522 256 419 419 256 521 516 516 516
516 516 554 256 419 256 553 516 516 516 518 516 554 256 419 256 521 518 516 518
518 516 518 555 555 555 516 518 518 516 518 518 516 555 555 555 516 518 516 518
389 389 389 713 650 650 650 650 650 650 650 650 650 650 650 650 713 389 389 389
389 389 389 651 683 683 683 683 683 683 683 683 683 683 683 683 651 389 389 389
518 587 587 586 864 865 866 672 673 674 675 676 677 928 929 930 256 585 518 518
522 256 419 256 896 897 898 704 705 706 707 708 709 960 961 962 419 256 521 516
518 554 256 419 256 256 419 256 256 419 256 256 419 256 256 419 256 553 516 518
516 518 555 554 256 419 256 419 256 419 256 419 256 256 419 256 553 516 518 518
518 516 518 516 555 555 554 256 256 256 419 256 256 553 555 555 516 516 516 516
864 865 866 516 518 516 516 555 554 256 419 256 553 516 518 516 516 740 741 742
896 897 898 516 518 518 516 518 518 554 256 419 521 518 516 516 518 772 773 774
516 518 518 518 516 518 516 516 516 522 256 553 516 516 518 516 516 518 518 516
580 580 580 580 580 580 516 518 516 516 555 516 516 516 516 580 580 580 580 580
740 801 742 937 938 939 550 516 516 740 741 742 516 518 582 743 744 936 809 874
832 773 774 969 970 971 550 516 516 772 773 774 516 516 582 775 997 968 903 839
419 419 256 256 426 548 516 518 522 256 419 419 521 518 516 520 520 520 520 457
256 419 419 256 256 585 516 518 516 555 488 555 516 516 586 419 419 256 256 521
419 256 256 419 419 256 521 516 516 586 256 521 518 522 256 256 256 419 419 585
554 256 256 419 256 553 518 516 522 256 419 521 516 518 554 419 256 419 256 256
516 555 555 554 256 521 516 518 522 419 256 521 516 516 522 256 419 553 555 555
