FE6 - Cave - 5300bdbe
23 20
257 34 130 71 226 420 34 71 70 39 34 258 160 483 484 160 293 389 228 384
289 39 71 66 290 160 261 34 100 38 71 290 355 352 416 291 325 102 102 103
321 34 66 103 322 160 420 34 134 70 135 322 387 384 448 325 34 66 70 135
66 102 103 70 66 290 160 484 257 66 103 103 102 34 34 34 134 66 33 2
100 38 131 39 34 322 160 160 160 486 66 70 66 38 135 34 134 34 71 135
66 70 70 39 39 485 160 160 420 325 38 106 39 70 260 196 257 38 135 34
483 261 34 34 71 324 288 416 293 34 134 135 71 258 160 160 291 70 103 102
160 160 259 134 66 103 320 448 325 38 135 34 71 290 160 291 325 66 66 38
160 160 160 257 34 102 103 34 66 70 39 103 34 322 451 323 34 39 66 38
290 355 352 416 486 134 34 66 66 66 38 38 39 485 160 259 134 70 39 71
322 387 384 448 325 66 34 258 259 34 130 71 66 322 160 160 486 34 71 34
34 134 38 38 131 39 34 292 291 102 66 256 483 484 160 291 325 66 260 196
196 261 70 39 70 66 102 324 325 70 103 322 292 160 291 325 66 66 290 160
160 293 38 39 38 39 38 135 34 38 131 39 324 451 325 102 66 34 322 288
293 325 34 39 71 66 70 103 102 70 71 71 258 160 257 70 39 39 103 320
325 102 38 71 256 483 195 66 102 100 134 34 290 160 160 486 70 71 70 260
131 39 38 106 322 352 160 261 134 135 34 34 322 290 289 325 34 39 34 290
70 71 71 66 103 322 292 160 257 134 34 38 135 322 321 66 34 71 66 322
38 71 66 38 131 39 324 290 289 134 38 38 39 103 102 100 38 135 38 39
130 39 39 66 66 39 103 322 321 34 38 131 39 39 34 38 131 103 34 34
98 39 70 66 66 34 39 39 38 39 39 71 135 71 194 259 134 38 71 66
70 71 258 196 261 71 70 131 98 71 70 70 135 485 160 160 261 70 260 483
34 66 290 160 160 483 261 70 71 71 33 100 39 324 290 160 293 34 290 160
