newcastle4
20 48
459 784 785 785 785 459 784 33 33 785 459 784 33 33 785 459 784 785 785 785 459 723 722 722 722 722 722 722 722 722 722 722 722 722 722 722 722 459 784 785 785 797 827 799 785 785 785 459
459 784 656 657 785 496 784 656 657 785 449 784 656 657 785 449 784 656 657 785 449 720 721 719 721 721 721 721 721 721 721 721 721 721 721 721 721 459 784 719 784 829 624 831 785 719 784 459
459 784 688 689 785 496 784 688 689 785 481 784 688 689 785 481 784 688 689 785 481 720 721 751 721 721 721 721 721 525 746 746 493 720 721 721 721 459 784 783 785 656 595 657 785 783 785 459
459 784 785 785 785 459 784 785 785 785 459 784 785 785 785 459 784 785 785 785 459 720 721 721 721 721 721 721 721 459 819 849 459 720 721 721 721 459 784 33 785 688 627 689 785 33 785 459
525 30 30 30 30 30 30 30 30 30 30 30 30 30 30 30 30 30 30 30 30 30 30 30 31 720 719 719 721 459 851 419 459 720 719 719 721 93 30 30 31 452 454 453 93 30 30 95
459 122 417 418 58 58 58 58 58 58 58 58 58 58 58 58 58 58 58 58 58 58 58 58 59 720 751 751 721 748 746 746 749 720 751 751 721 121 58 58 59 452 454 453 121 58 58 123
459 823 825 825 825 655 722 722 722 459 723 722 722 722 722 722 722 722 722 722 722 722 722 722 722 721 721 721 721 722 722 722 722 721 721 721 721 722 722 722 719 656 595 657 719 722 722 722
459 820 821 821 821 626 721 721 721 459 720 721 721 721 593 561 561 594 721 721 721 721 721 721 721 721 721 721 721 721 719 719 721 721 721 721 721 721 719 721 751 688 627 689 751 721 719 721
459 820 821 821 821 687 721 721 721 459 720 721 721 721 721 721 721 721 721 721 721 721 721 721 721 721 721 721 721 721 751 751 721 721 721 721 721 721 751 721 721 721 721 721 721 721 751 721
459 820 821 821 821 459 720 721 721 490 720 721 721 525 746 746 746 746 493 720 721 721 484 746 746 746 746 746 484 656 595 595 657 525 746 746 493 720 721 721 458 720 719 721 458 720 721 721
459 820 821 821 821 459 720 719 721 722 721 719 721 459 487 849 849 419 459 720 719 721 459 928 929 929 929 929 516 688 627 627 689 459 819 849 459 720 719 721 458 720 751 721 458 720 719 721
459 820 821 821 821 459 720 751 721 721 721 751 721 748 746 746 746 746 749 720 751 721 587 69 131 131 131 131 386 821 821 821 821 459 487 849 459 720 751 721 458 720 487 721 458 720 751 721
459 820 821 821 821 459 720 721 721 719 721 721 721 722 722 722 722 722 722 721 721 721 587 69 131 131 131 131 422 821 719 719 821 748 746 746 749 720 487 721 490 720 721 721 490 720 487 721
459 820 821 821 821 459 720 721 721 751 721 721 721 721 593 561 561 594 721 721 721 721 587 69 131 131 131 131 422 821 815 815 821 825 825 656 657 721 721 721 722 656 595 657 722 721 721 721
459 820 821 821 821 459 720 721 721 721 721 721 721 721 721 721 721 721 721 721 721 721 587 69 131 131 131 131 422 821 821 821 821 821 821 596 628 721 719 721 721 596 530 628 721 721 719 721
459 452 454 454 453 484 746 746 746 746 746 746 746 746 746 746 746 746 746 746 746 746 484 69 131 131 131 131 459 820 821 821 821 821 821 688 689 721 751 721 721 688 627 689 721 721 751 721
459 452 454 454 453 743 928 929 929 929 929 929 929 929 929 929 929 929 929 929 929 929 930 101 131 131 131 131 459 820 821 821 821 746 746 746 746 720 721 721 746 746 746 746 746 720 721 721
131 131 131 131 131 131 131 131 131 131 131 194 131 224 224 131 194 131 131 131 131 131 131 131 131 131 131 131 459 820 719 719 821 824 824 656 657 721 719 721 722 722 722 722 722 721 719 721
131 131 131 131 131 131 131 131 131 131 194 131 224 224 224 224 194 194 194 131 131 131 131 131 131 131 131 131 459 820 815 815 821 821 821 596 628 721 751 721 721 721 719 721 721 721 751 721
131 131 131 131 131 131 131 131 131 194 131 194 131 224 224 224 131 194 194 131 131 131 131 131 131 131 131 131 459 820 821 821 821 821 821 688 689 721 721 721 721 721 751 721 721 721 721 721
