FE8 - Village - 0e000f10
18 15
876 896 778 901 522 578 192 192 192 192 521 516 484 484 484
844 0 516 555 522 419 288 288 288 288 0 484 484 484 484
548 555 516 518 516 555 549 428 428 520 516 484 484 484 484
877 912 389 389 911 931 932 933 934 935 484 484 484 484 484
548 548 518 580 0 963 964 965 966 967 484 484 864 865 866
516 518 518 740 741 742 457 457 457 457 484 516 896 996 898
0 516 516 772 835 836 489 516 516 587 580 580 518 516 554
908 454 518 555 423 554 128 521 0 0 877 912 461 516 516
555 516 516 518 516 484 457 0 0 672 673 674 164 239 165
516 516 516 484 484 580 987 493 954 704 705 706 202 516 516
516 302 516 516 516 516 516 522 0 132 555 580 580 580 580
516 516 516 516 516 516 516 911 877 0 522 192 192 192 192
518 516 516 516 516 516 516 457 548 549 522 192 192 192 192
650 650 713 389 389 713 454 516 522 928 871 810 934 936 806
714 683 651 525 525 687 454 518 516 840 838 842 897 968 778
386 954 954 525 525 754 454 516 516 518 516 520 520 520 520
525 384 384 525 525 687 454 516 516 516 522 419 578 578 578
525 525 525 525 525 687 454 516 516 516 587 427 419 288 288
