Village v2 - Standard Tileset
25 20
28 29 30 90 91 27 92 93 361 79 80 81 454 148 94 95 90 91 92 93
60 61 62 122 63 58 63 125 454 111 112 113 361 89 126 127 122 123 63 125
361 361 454 489 489 489 454 454 361 454 454 454 489 489 489 454 361 454 454 454
454 454 490 419 193 193 488 454 361 361 454 458 193 419 193 488 454 361 454 361
361 458 193 193 419 419 193 456 454 361 454 458 193 419 419 193 456 361 361 361
361 361 426 193 419 193 424 454 361 454 361 454 426 193 419 193 456 454 454 361
454 454 454 425 425 425 454 454 454 361 361 454 454 425 425 425 454 361 454 454
276 277 278 589 591 591 591 591 591 591 591 591 591 591 591 591 589 276 277 278
276 277 278 621 623 623 623 623 623 623 623 623 623 623 623 623 621 276 277 278
361 489 489 490 90 91 93 15 16 17 18 19 20 148 94 95 193 488 454 454
458 193 419 193 122 63 125 47 48 49 50 51 52 88 126 127 419 193 456 454
454 426 193 419 193 193 419 193 193 419 193 193 419 193 193 419 193 424 454 361
361 361 425 426 193 419 193 419 193 419 193 419 193 193 419 193 424 454 361 361
361 454 454 361 425 425 426 193 193 193 419 193 193 424 425 425 454 454 454 454
90 91 93 361 454 361 454 425 426 193 419 193 424 454 361 454 454 28 29 30
122 63 125 454 454 361 361 454 454 426 193 419 456 454 361 361 454 60 61 62
454 454 454 454 454 454 361 454 454 458 193 424 454 361 361 454 454 454 361 454
454 454 454 454 454 454 361 454 454 454 425 454 454 361 454 454 454 454 454 361
28 29 30 79 80 81 454 454 454 28 29 30 454 454 454 90 91 25 94 95
60 61 62 111 112 113 454 454 454 60 61 62 454 454 454 122 123 57 126 127
419 419 193 193 488 454 361 361 458 193 193 193 456 361 454 489 521 489 489 361
193 419 419 193 193 488 361 361 454 425 521 425 454 361 490 419 419 193 193 456
419 193 193 419 419 193 456 454 454 490 193 456 454 458 193 193 193 419 419 488
426 193 193 419 193 424 454 361 458 193 419 456 361 454 426 419 193 419 193 193
454 425 425 426 193 456 361 454 458 419 193 456 361 361 458 193 419 424 425 425
