Village v2 - Standard Tileset
19 15
29 30 79 80 81 678 28 29 30 148 94 95 18 19 20
61 62 111 112 113 678 60 61 62 89 126 127 50 51 52
361 489 489 454 454 678 877 877 877 877 877 877 877 877 877
458 419 224 488 454 678 877 877 877 877 877 877 877 877 877
458 419 419 224 456 678 877 877 877 877 877 877 877 877 877
458 224 224 424 361 589 591 591 591 589 244 245 589 591 591
454 426 419 456 454 621 623 623 623 621 276 277 621 623 623
454 361 425 454 454 361 361 454 361 454 454 454 361 454 454
361 361 454 361 454 454 454 361 361 361 454 454 361 361 454
361 454 454 361 454 454 454 454 361 454 454 454 454 454 454
361 454 148 94 59 92 93 454 454 454 28 29 22 91 93
454 454 89 126 57 124 125 454 361 454 60 61 54 121 125
454 489 489 489 489 489 454 454 361 361 454 454 454 454 454
458 419 419 224 419 419 456 454 454 361 454 361 361 454 454
361 426 419 327 224 419 456 361 454 454 454 454 361 361 454
361 454 425 454 425 425 454 361 454 454 454 454 454 454 454
591 591 591 591 591 591 591 589 276 277 277 278 589 591 591
623 623 623 623 623 623 623 621 276 277 277 278 621 623 623
623 623 623 623 623 623 623 621 276 277 277 278 621 623 623
