Village v2 - Standard Tileset
10 15
30 90 92 93 79 80 81 529 148 94 95 15 16 17 419
62 122 63 125 111 112 113 529 89 126 127 47 48 49 192
419 192 456 454 454 454 454 529 454 454 454 454 454 454 454
192 424 454 454 454 589 591 715 454 454 454 454 454 454 454
425 454 454 454 489 621 623 621 370 495 591 591 591 496 370
591 591 496 490 419 456 454 454 454 90 91 23 29 30 454
986 814 814 419 192 456 454 454 454 122 123 55 61 62 454
1018 846 846 192 520 489 454 454 454 454 454 454 454 454 454
986 877 877 192 192 192 488 489 454 454 454 454 454 454 454
1018 782 877 192 419 192 192 192 456 454 454 454 454 495 591
